
Bölgesel ve erişebilirlik
-------------------------

Erişilebilirlik: Erişilebilirlik ayarlarını içerir
Girdi eylemleri: Fare mimikleri ve klavye ayarlarını değiştirir
Tarih ve saat: Sistemin tarih ve saat bilgisini değiştirmeyi sağlar
Ülke, bölge ve dil: Bilgisayarın dilini ve ülke ayarlarını değiştirmeyi sağlar


Çevre birimleri
---------------
Dizüstü pil: Dizüstü bilgisayarın kullandığı pille ilgili ayarlar yapar
Fare: Fare hareketini, düğmesini ve imleç temasını düzenler
Görüntü: Monitörün boyutunu, konumunu ve tazeleme sıklığını ayarlar
Klavye düzeni: Klavye ayarlarını (Türkçe, İngilizce vb) yapar
Klavye kısayolları: Kısayol ayarlarını düzenler ve kaydeder
Yazıcılar: Yeni yazıcı tanımlar ve yazıcı ayarlarını düzenler

Temalar 
-------
Açılış ekranı: Pardus açılırken görüntülenen resmi düzenler
Arkaplan: Arkaplan resmini ya da rengini ayarlar
Ekran koruyucu: Ekran koruyucu ayarlarını yapar
Pencere dekorasyonları: Pencerelerin başlık kısmındaki renkleri ve düğmeleri ayarlar
Renkler: KDE programlarının renklerini düzenler
Simgeler: Pardus'ta kullanılan simgeleri belirler
Stil: Pardus'un pencere arayüz stilini düzenler
Yazıtipleri: Yazıtiplerini ve boyutlarını düzenler

Internet ve yerel ağ
--------------------
Ağ yapılandırması: Ethernet, kablosuz ağ ya da modem ayarlarını yapar
Vekil sunucu: Konqueror için vekil sunucu ayarlarını yapar
Yerel ağ tanıma: Yerel ağdaki makineleri taramak için kullanılır

Kullanıcı hesabı
----------------
Gizlilik: Kullanıcı hesabı gizlilik ve güvenliğini düzenler
Parola & Kullanıcı Hesabı: Kullanıcı resmini ve parolasını düzenler
Şifreleme: SSL şifreleme ayarlarını yapar

Masaüstü seçenekleri
--------------------
Bileşen seçici: Belirli işlevlere karşılık gelen programları tanımlar
Çoklu masaüstü: Birden fazla masaüstü ayarlarını yapmak için kullanılır
Dosya ilişkileri: Dosya sonekleri ile eşleşen programları düzenler
Görev çubuğu: KDE görev çubuğunun davranışını düzenler
Paneller: KDE panelinin boyut, şekil ve rengini ayarlar
Pencere davranışı: Pencerelerin odaklama, taşıma ve şeffaflık seçeneklerini ayarlar

Ses ve çokluortam
-----------------
Ses sistemi: KDE ses sistemini düzenler
Sistem bildirimleri: Tanımlı bir eylemde çıkartılacak sesi ayarlar
TV kartı yapılandırması: Kullanılan TV kartının seçeneklerini düzenler

Sistem seçenekleri
------------------
Kullanıcı ekle ve çıkart: Sisteme yeni bir kullanıcı eklemek ya da çıkartmak için kullanılır
Program ekle, güncelle ve kaldır: Program eklemek, güncellemek ya da kaldırmak için kullanılır


